11111111111111111111111111111111111111111111111111111111111
10000000000000000000000000000000000000001110000000000011001
10000000000000000000000000000000000000001110000000000011001
10000000000000000000000000000000000000001110000000000011001
10000000000000000000000000000000000000001110000000000011001
10000000000000000000000000000000000000001110000000000011001
10000000000000000000000000000000000000001110000000000011001
100000000000000000000C0000000000000000001110000000000011001
10000000000000000000000000000000000000001110000000000011001
10000000000000000000000000000000000000001110000000000011001
10000000000000000000000000000000000000001110000000000011001
10000000000000000000000000000000000000001110000000000011001
10000000000000000000000000000C00000000001110000000000011001
10000C00000000000000000000000000000000001110000000000011001
10000000000000000000000000000000000000001110000000000011001
10000000000000000000000000000000000000001110000000000011001
10000000000000000000000000000000000000001110000000000011001
10000000000000000000000000000000000000001110000000000011001
10000000000000000000000000000000000000001110000000000011001
10000000000000000C000000000000000000000011100000E0000011001
100000000000000000000000000000000000E0001110000000000011001
10000000000000000000000000000000000000001110000000000011001
10000000000000000000000000000000000000001110000000000011001
10000C00000000000000000000000000000000001110000000000011001
1000000000000000000000000000000000000000111C000000000011001
11111111111111111111111111111111111111111111111111111111111
