11111111111111111111111111111111111111111111111111111111111111111111
10000000000000000000000000000010000000000000000000000000000000000001
100000000000000000000011111111100000000000000P0C10000000000000000001
10111111111111111111110000000000000000000000100100000000000000000001
100000000000000000000000C0000000000000000000100100000000000000000001
10000000000000000000000000000000000000000011000100000000000000000001
10111111111111111111110000000000000011111100000100000000000000000001
10000000000000000000000000000000011100000000000100000000000000000001
10111111111100000000000000000000100000000000000100000000000000000001
10000000000100001000011111111111000000000000000100000000000000000001
10000000000100010000100000000000000000000000000100000000000000000001
10000000000100011100100000000000000000000000000100000000000000000001
10000000000100010010000001111111111111111111111110000000000000000001
10000000000100001010011110000000000000000000000000000000000000000001
10000000000100000110011110000000000000000000000000000000000000000001
10000000000100001010011110000000000000000000000000000000000000000001
10000000000100001110011110000000000000000000000000000000000000000001
100000000001000000000111100000000000000000E0000000000000000000000001
11111111111111111111111111111111111111111111111111111111111111111111
