11111111111111111111111111111111111111111111111111111111111111111111111111111
10000000000000000000000000000000000000000000000000000000000000000000000000001
1001110010000111001000001001110010001001110010010000100C000000000000000000001
10001000100001010001000100010000010100010100100100001000000000000000000000001
1000100010000101000010100001100000100001010010010000100C000000000000000000001
100111001110011100000100000100000010000111001111000000000000000P0000000000001
10000000000000000000000000011100000000000000000000001000000000000000000000001
10000000000000000000000000000000000000000000000000000000000000000000000000001
1000000000000000000000000000000000000000000000E000000CC0000000000000000000001
10000000000000000000000000000000000000000000000000000000000000000000000000001
10000000000000000000000000000000000000000000000000000000000000000000000000001
10000000000000000000000000000000000000000000000000000000000000000000000000001
10000000000000000000000000000000000000000000000000000000000000000000000000001
10000000000000000000000000000000000000000000000000000000000000000000000000001
11111111111111111111111111111111111111111111111111111111111111111111111111111
