111111111111111111111111
100100001111000111100001
100100001110000101100001
1001110010000001111000E1
1P000000000000C000000001
100000000000000000000001
100000000000000000000001
100000000000000000000001
100000000000000000000001
100000000000000000000001
100000000000000000000001
111111111111111111111111
