1111111111111111111111
1PEC000000000000000001
1E00000000E00000000001
10E1000000000000001E01
1111111111111111111111
